XXXXXXXXXXXXXX
X*XXX XXXXXXXX
X            X
X XX XXXXX X X
XXXX XX    X X
X@    XXXXXXXX
XXXXXXXXXXXXXX